+--$---------$--+
|. . . . . . . .|
|               |
$. . . . . . . .$
|               |
|. . . . . . . .|
|               |
|. . . . . . . .|
|               |
|. . . . . . . .|
|               |
|. . . . . . . .|
|               |
$. . . . . . . .$
|               |
|. . . . . . . .|
+--$---------$--+