+----$----------+
|. . . . . . . .|
|               |
|. . . . . . . .$
|               |
$. . . . . . . .|
|               |
|. . . . . . . .|
+------------$--+