+----$--+
|. . . .|
|       |
|. . . .$
|       |
$. . . .|
|       |
|. . . .|
+--$----+